11111111
10001001
1P0110C1
11100E11
11111111
