11111111
10000001
1P0010C1
11100E11
11111111