1111111111
1P000000C1
1110111111
1C00000001
1001111001
1010001001
1011101001
10000000E1
1C11111001
1111111111
