1111111
1P000C1
1011101
1C00001
1111101
1E00001
1111111